2 2 2 2 2 12 10 10 13 2 2 2 2 2 2 2 2 2 2 2 2 2 2 2 2 2 2 2 2 2 2 2 2 2 2 2 2 2 2 2 2 2 2 2 2 2 2 2 2 2
2 2 2 2 16 8 3 3 7 16 2 2 2 2 1 1 1 2 2 2 2 2 2 2 2 2 2 2 2 2 2 2 2 16 2 2 2 2 2 2 2 2 2 2 2 2 2 2 2 2
2 2 2 2 16 8 3 3 7 2 33 2 16 1 1 1 1 1 2 2 2 2 2 2 2 2 2 2 2 2 2 2 2 2 2 2 2 2 2 33 2 2 2 2 2 2 2 2 2 2
2 2 2 16 2 8 3 3 7 16 2 16 2 1 1 1 2 2 2 2 2 32 2 2 2 2 2 2 2 16 2 16 16 2 16 2 2 2 2 2 2 2 2 2 33 1 2 2 33 2
2 2 2 2 16 14 5 5 16 2 16 16 2 2 1 1 2 2 2 2 32 32 32 2 2 2 2 2 2 16 16 2 16 2 2 2 2 33 2 2 2 2 2 2 2 1 1 1 1 2
2 2 2 2 16 2 16 2 16 2 2 2 2 2 2 2 2 2 2 2 2 32 2 2 2 2 2 2 2 16 16 2 16 16 2 2 2 2 2 2 33 2 33 2 1 33 2 2 1 2
17 17 17 17 17 17 17 17 17 17 17 17 17 17 17 17 17 17 17 17 2 2 2 2 2 2 2 2 16 2 16 2 16 2 2 2 2 2 33 16 33 2 2 17 32 17 2 2 2 2
17 17 17 17 17 17 17 17 17 17 17 17 17 17 17 17 17 17 17 17 2 2 2 2 2 2 2 2 2 2 2 16 16 2 2 2 33 2 2 16 33 2 33 17 32 32 2 33 16 2
17 17 17 17 17 17 17 17 17 17 17 17 17 17 17 17 17 17 17 17 2 2 2 2 2 2 2 2 16 16 16 2 2 16 2 2 2 33 16 33 2 2 32 32 32 33 36 34 17 17
2 2 2 2 2 2 2 2 2 2 2 2 2 2 2 2 2 17 17 17 2 2 2 2 2 2 2 2 1 1 16 16 2 16 2 2 2 2 16 16 2 2 33 34 32 17 35 17 17 2
2 2 2 2 2 2 2 2 2 2 2 2 2 2 2 2 2 17 17 17 2 2 2 2 2 2 2 2 1 1 16 16 2 16 2 2 2 2 33 2 2 16 2 34 32 34 34 16 2 16
2 2 2 2 2 2 2 2 2 2 2 2 2 2 2 2 2 17 17 17 2 2 2 2 2 2 2 2 16 1 16 2 2 16 2 2 2 2 2 2 33 2 33 2 32 2 16 2 33 2
2 2 2 2 2 2 2 2 2 2 2 2 2 2 2 2 2 17 17 17 2 2 2 2 2 2 2 16 1 16 2 2 16 2 16 16 2 2 2 20 21 21 22 33 33 33 2 33 33 2
2 2 2 1 2 1 1 2 2 2 2 2 2 1 1 1 2 17 17 17 2 2 2 2 2 2 2 2 2 16 16 16 2 16 2 2 2 2 16 23 18 18 24 17 17 17 16 2 16 2
2 2 2 1 2 1 1 1 2 2 2 2 2 1 2 1 2 17 17 17 2 2 2 2 2 2 2 2 2 16 2 16 2 2 16 2 2 2 2 23 19 18 24 17 17 17 2 2 2 16
2 2 2 2 1 1 1 1 2 2 2 2 2 2 1 1 2 17 17 17 2 2 2 2 2 2 2 2 2 2 2 16 2 16 16 2 2 2 16 23 19 18 24 17 17 17 2 16 2 2
2 2 2 2 2 1 1 1 2 2 2 2 2 2 2 1 2 17 17 17 2 2 2 2 2 2 2 2 2 2 2 2 16 16 16 2 16 2 2 23 18 18 24 17 17 17 2 2 2 2
2 2 2 2 2 2 2 2 2 2 2 2 2 2 2 2 2 17 17 17 2 2 2 2 2 2 2 2 2 2 2 2 2 2 2 2 2 2 2 23 18 19 24 17 17 17 2 2 2 2
2 2 2 2 2 2 2 2 2 2 2 2 2 2 2 2 2 17 17 17 2 2 2 2 2 2 2 2 2 2 2 2 2 2 16 2 2 2 2 23 18 19 24 17 17 17 2 2 2 2
2 2 16 16 16 16 16 16 2 2 2 2 2 2 2 2 2 17 17 17 2 2 2 2 2 2 2 2 2 2 2 2 2 2 2 2 2 2 2 23 19 18 24 17 17 17 2 2 2 2
2 2 16 16 2 2 2 16 16 16 2 2 2 2 1 1 2 17 17 17 2 2 2 2 2 2 2 2 2 2 2 2 2 2 2 2 2 16 2 23 18 18 24 17 17 17 2 2 2 2
2 16 16 20 21 21 21 22 2 2 16 2 2 2 1 1 2 17 17 17 2 2 2 2 2 2 2 2 2 2 2 2 2 2 2 2 2 2 2 23 19 18 24 17 17 17 2 2 2 2
16 16 2 23 28 29 19 24 2 2 16 16 2 2 1 2 2 17 17 17 2 2 2 2 2 2 2 2 2 2 2 2 2 2 2 2 2 2 1 23 19 19 24 17 17 17 2 2 2 2
16 16 16 23 30 31 29 24 2 2 16 16 1 1 1 2 2 17 17 17 2 2 2 1 1 2 2 2 2 2 2 2 2 2 2 2 2 2 1 23 18 18 24 17 17 17 2 2 2 2
16 16 2 23 19 30 31 24 2 16 16 16 1 1 1 2 2 17 17 17 2 2 2 1 1 1 2 2 2 2 2 2 2 2 2 2 2 1 1 23 18 19 24 17 17 17 2 2 2 2
2 2 2 25 26 26 26 27 2 16 1 16 1 1 2 2 2 17 17 17 2 2 2 1 1 2 20 21 21 21 21 21 21 21 21 21 21 21 21 31 18 19 24 17 17 17 2 2 2 2
16 16 16 2 2 2 2 2 16 2 1 1 1 1 2 2 2 17 17 17 2 2 2 2 2 20 31 19 18 19 18 19 19 19 19 18 18 18 19 19 19 18 24 17 17 17 2 2 2 2
2 2 16 16 16 33 2 16 2 2 1 1 1 2 2 2 2 17 17 17 2 2 2 2 20 31 19 18 18 19 19 19 19 18 18 19 18 18 18 19 19 28 27 17 17 17 2 2 2 2
2 2 2 16 2 2 16 2 2 16 2 1 2 2 2 2 2 17 17 17 2 2 2 2 23 18 18 28 26 26 26 26 26 26 26 26 26 26 26 26 26 27 2 17 17 17 2 2 2 2
2 2 16 2 2 16 2 2 2 2 2 2 2 2 2 2 2 17 17 17 2 2 2 2 23 19 19 24 2 2 1 2 2 2 2 2 2 1 1 1 2 1 2 17 17 17 2 2 2 2
2 2 2 2 2 2 2 2 2 2 2 2 2 2 2 2 2 17 17 17 2 2 1 1 23 19 19 24 1 1 1 1 2 2 2 2 1 1 1 1 1 1 2 17 17 17 2 2 2 2
2 2 2 2 2 2 2 2 1 1 1 1 1 1 1 2 2 17 17 17 2 2 1 2 23 19 18 24 1 17 17 17 17 17 17 17 17 17 17 17 17 1 2 17 17 17 2 2 2 2
2 2 2 2 2 2 2 2 1 2 2 1 1 1 1 2 2 17 17 17 2 2 1 1 23 19 19 24 1 17 17 17 17 17 17 17 17 17 17 17 17 2 2 17 17 17 2 2 2 2
2 2 2 2 2 2 2 2 1 2 2 1 1 1 1 1 2 17 17 17 2 2 2 1 23 19 19 24 1 17 17 17 17 17 17 17 17 17 17 17 17 2 2 17 17 17 2 2 2 2
2 2 2 2 2 2 2 2 1 1 1 1 1 1 1 1 2 17 17 17 2 2 2 2 23 3 3 24 1 17 17 17 2 2 2 2 2 2 17 17 17 2 2 17 17 17 2 2 2 2
2 2 2 2 2 2 2 2 2 2 1 1 1 2 2 1 2 17 17 17 2 1 1 2 23 19 3 24 2 17 17 17 2 2 2 2 2 2 17 17 17 2 2 17 17 17 2 2 2 2
2 2 2 2 2 2 2 2 2 2 2 2 1 1 1 1 2 17 17 17 2 1 1 1 23 3 3 24 2 17 17 17 2 2 2 2 2 2 17 17 17 17 17 17 17 17 2 2 2 2
2 2 2 2 2 2 2 2 2 2 2 2 2 2 2 2 2 17 17 17 2 1 1 1 23 3 3 24 2 17 17 17 2 2 2 2 2 2 17 17 17 17 17 17 17 17 2 2 2 2
2 2 2 2 2 2 2 2 2 2 2 2 2 2 2 2 2 17 17 17 2 1 1 1 23 3 3 24 2 17 17 17 2 2 2 2 2 2 17 17 17 17 17 17 17 17 2 2 2 2
2 2 2 2 2 2 2 2 2 2 2 2 2 2 2 2 2 17 17 17 2 1 1 2 3 3 3 24 2 17 17 17 2 2 2 2 2 2 2 2 2 2 2 2 2 2 2 2 2 2
2 2 2 2 2 2 2 2 2 2 2 2 2 2 2 2 2 17 17 17 17 17 17 17 17 17 17 17 17 17 17 17 2 2 2 2 2 2 2 2 2 2 2 2 2 2 2 2 1 1
2 2 2 2 2 2 2 2 2 2 2 2 2 2 1 2 2 17 17 17 17 17 17 17 17 17 17 17 17 17 17 17 2 2 2 2 2 2 2 2 2 2 2 2 2 2 2 1 1 1
2 2 2 2 2 2 1 1 1 1 1 2 2 2 1 1 2 17 17 17 17 17 17 17 17 17 17 17 17 17 17 17 2 2 2 2 2 2 2 2 2 2 2 2 2 2 16 16 16 1
2 2 2 2 1 1 1 1 1 2 1 2 2 2 2 2 2 2 2 2 2 2 2 2 2 2 2 2 2 2 2 2 2 2 2 2 2 2 1 1 16 1 1 2 2 16 16 1 1 2
2 2 2 2 1 1 1 1 1 1 1 2 2 2 2 2 2 2 2 2 2 1 16 3 3 3 3 16 3 2 2 2 2 2 2 2 2 1 1 16 1 1 1 16 16 2 2 1 1 2
2 2 2 2 2 1 1 1 1 1 2 2 2 2 2 2 2 2 2 2 2 1 3 3 3 19 3 3 3 3 3 2 2 2 2 2 2 1 2 2 1 1 1 16 2 2 2 1 1 2
2 2 2 2 2 2 2 2 2 2 2 2 2 2 2 2 2 2 2 2 2 16 3 19 3 3 16 3 18 3 3 2 2 2 2 2 2 1 16 1 1 1 1 2 2 2 2 2 2 2
2 2 2 2 2 2 2 2 2 2 2 2 2 2 2 2 2 2 2 2 2 1 3 3 20 22 3 36 32 3 3 2 2 2 2 2 2 2 2 1 1 1 1 2 2 2 2 16 2 2
2 2 2 2 2 2 2 2 2 2 2 2 2 2 2 2 2 2 2 2 2 3 3 3 25 27 3 33 18 3 16 2 2 2 2 2 2 16 2 1 1 2 16 2 2 2 2 2 2 2
2 2 2 2 2 2 2 2 2 2 2 2 2 2 2 2 2 2 2 2 16 16 19 3 3 3 3 16 3 3 2 2 2 2 2 2 2 2 2 2 2 2 2 2 1 1 1 1 1 2
